NO ./images/42.png
SO ./images/wall2.png
WE ./images/wall.png
EA ./images/wall.png

F  ./images/floor.png
C  ./images/ceiling.png

                             111111111111111111111111
                             100000000000000000000001
                             100005000000000000000001
                             100000000000000000000001
                             100000010001000010100001
                             100000000000000000000001
                             100012122110000100000001
                             100000000000000001000001
                       111111111111111111111111100001
11111111111111111111111000000000000000000000000011001
1000000000000000000000000000000000100111111110100101
10000050000000050000000000000000012100005000001010001
10000000005000000000050000000000000000000000010501001
10000000000000000000000000000000000005000005001010001
10005050505050505005050505000000000000000000111011111
10000000000000000000000000000000000000105000102000551
10000000000050000005000000000000010000200000111001111
10000050000000050000000000000000000000000000001001001
10000000005000000005000000000000010000000000001001001
 1111111111110000010000500000000000000000001001001001
             1111111111110000000000000000000001211001
                       111111111111100000000001N110001
                             111111111111111111111111

